1 1 18
QWWWWWWWWWWWE
AS     B    D
A B   B     D
AB B   B   BD
AB  B    B BD
A  B       BD
A B    B    D
A B B      BD
A  B        D
A     B     D
AB   B  B   D
A  B        D
A FB        D
ZXXXXXXXXXXXC